1 1 1 1 1 1 1 1 1 1 1 1 1 1 1 1 1 1 1 1 1 1 1 1 1 1 1 1 1 1 1 1 1 1 1 1 1 1 1 1 1 1 1 1 1 1 1 1
1 1 1 2 2 2 2 2 2 2 2 2 2 2 2 2 2 2 2 2 2 2 2 2 2 2 2 2 1 4 6 5 7 1 2 2 2 2 2 2 2 2 2 2 2 2 2 1
1 1 1 0 0 0 0 0 0 0 0 0 0 0 0 0 0 0 0 0 0 0 0 5 0 0 0 0 1 4 6 5 7 1 0 0 0 0 0 0 0 0 0 0 0 0 0 1
1 1 1 0 0 0 0 0 0 0 0 0 0 0 0 0 0 0 0 0 0 0 0 5 0 0 0 0 1 1 1 1 1 1 0 0 0 0 0 0 0 0 0 0 0 0 0 1
1 1 1 0 0 0 1 1 1 1 1 1 1 1 0 0 0 1 1 1 1 1 1 1 0 0 0 0 2 2 2 2 2 1 7 7 7 6 6 6 5 5 5 1 1 1 1 1
1 1 1 0 0 0 2 2 2 2 1 1 1 1 0 0 0 1 1 1 1 1 1 1 0 0 0 0 0 6 0 0 0 1 0 0 0 0 0 0 0 0 0 0 0 0 0 1
1 1 1 0 0 0 6 0 0 0 1 1 1 1 2 2 2 1 1 1 1 1 1 1 1 1 0 0 0 6 0 0 0 1 0 0 0 0 0 0 0 0 0 0 0 0 0 1
1 1 1 0 0 0 6 0 0 0 1 1 1 1 2 2 2 1 1 1 1 1 1 1 1 1 1 1 1 1 0 0 0 1 1 1 1 1 1 1 1 1 1 1 4 4 4 1
1 1 1 1 1 1 1 0 0 0 5 0 0 1 0 0 0 0 0 0 0 0 0 7 0 0 0 0 0 4 0 0 0 0 0 0 0 0 0 0 0 0 0 0 0 0 0 1
1 0 0 0 0 0 7 0 0 0 5 0 0 1 0 0 0 0 0 0 0 0 0 7 0 0 0 0 0 4 0 0 0 0 0 0 0 0 0 0 0 0 0 0 0 0 0 1
1 0 0 0 0 0 7 0 0 0 5 0 0 1 2 2 2 1 1 1 1 1 1 1 1 1 1 1 1 1 1 1 1 1 1 1 1 1 1 1 1 1 1 1 1 1 1 1
1 0 0 0 0 0 1 1 1 1 1 1 1 1 4 4 4 1 1 1 1 1 1 1 1 1 1 1 1 1 1 1 1 1 1 1 1 1 1 1 1 1 1 1 1 1 1 1
1 0 0 0 0 0 1 1 1 1 1 1 1 1 2 2 2 1 1 1 1 2 2 2 2 2 2 2 2 2 2 2 2 2 2 2 2 2 2 2 2 2 2 2 2 2 2 1
1 0 0 0 0 0 2 2 2 2 2 2 2 2 2 2 2 1 1 1 1 0 0 4 0 0 1 0 0 0 0 0 0 0 0 0 0 0 0 0 0 0 0 0 0 0 0 1
1 0 0 0 0 0 0 0 0 0 0 0 0 0 0 0 0 1 4 7 1 0 0 4 0 0 1 0 0 0 0 0 0 0 0 0 0 0 0 0 0 0 0 0 0 0 0 1
1 0 0 0 0 0 0 0 0 0 0 0 0 0 0 0 0 1 5 6 1 0 0 1 0 0 1 0 0 0 0 0 0 0 0 0 0 0 0 0 0 0 0 0 0 0 0 1
1 0 0 0 0 0 0 0 0 0 0 0 0 0 0 0 0 1 6 5 1 0 0 1 0 0 1 0 0 0 1 1 1 1 1 2 2 1 1 1 1 1 1 1 1 1 1 1
1 0 0 0 0 0 0 0 0 0 0 0 0 0 0 0 0 1 7 4 1 0 0 1 7 7 1 0 0 0 1 1 1 1 1 2 2 1 2 2 2 2 2 2 2 2 2 1
1 2 2 1 1 1 1 1 1 1 1 1 1 1 1 1 1 1 1 1 1 5 5 1 0 0 1 0 0 0 1 1 2 2 2 2 2 1 2 2 2 2 2 2 2 2 2 1
1 0 0 0 0 0 5 0 0 7 0 0 4 0 0 6 2 2 2 2 2 0 0 1 0 0 1 0 0 0 1 1 2 2 2 2 2 1 2 2 1 1 1 1 1 2 2 1
1 0 0 0 0 0 5 0 0 7 0 0 4 0 0 6 2 2 2 2 2 0 0 1 0 0 1 0 0 0 1 1 2 2 1 1 1 1 2 2 1 1 1 1 1 2 2 1
1 0 0 0 0 0 5 0 0 7 0 0 4 0 0 6 2 2 2 2 2 0 0 1 0 0 6 0 0 0 1 1 2 2 2 2 2 2 2 2 1 1 1 1 1 0 0 1
1 0 0 0 0 0 5 0 0 7 0 0 4 0 0 6 2 2 2 2 2 0 0 1 0 0 6 0 0 0 1 1 2 2 2 2 2 2 2 2 1 1 1 1 1 0 8 1
1 1 1 1 1 1 1 1 1 1 1 1 1 1 1 1 1 1 1 1 1 1 1 1 1 1 1 1 1 1 1 1 1 1 1 1 1 1 1 1 1 1 1 1 1 1 1 1